# dictionary of unit conversions for the recipe parser
cup	c.
cups	c.
c	c.
c.	c.
tbsp	Tbsp
Tbsp	Tbsp
T	Tbsp
tbs	Tbsp
TBS	Tbsp
tbsp.	Tbsp
Tbsp.	Tbsp
Tablespoon	Tbsp
Tablespoons	Tbsp
tablespoon	Tbsp
tablespoons	Tbsp
tsp	tsp
Tsp	tsp
t	tsp
tsp.	tsp
Tsp.	tsp
tsps	tsp
teaspoon	tsp
teaspoons	tsp
Teaspoon	tsp
Teaspoons	tsp
pound	lb^
pounds	lb^
lb	lb^
lb.	lb^
lbs	lb^
lbs.	lb^
oz	oz
oz.	oz
ounce	oz
ounces	oz
gram	g
grams	g
Gram	g
Grams	g
g	g
kilogram	kg
kilograms	kg
Kilograms	kg
Kilogram	kg
kg	kg
ml	ml
mL	ml
milliliter	ml
milliliters	ml
millilitre	ml
millilitres	ml
L	L
liter	L
liters	L
litre	L
litres	L
bunch	bunch^^
bunches	bunch^^
head	head^
heads	head^
can	can^
cans	can^
cloves	clove^
clove	clove^
handful	handful^
handfuls	handful^
stick	stick^
sticks	stick^
